TESTNLLRANKS:,CAWPE-S,TunedRandF,TunedXGBoost,TunedSVM,TunedMLP
abalone,2.0,3.0,5.0,4.0,1.0
acute-inflammation,2.0,4.0,5.0,1.0,3.0
acute-nephritis,2.0,3.0,4.0,1.0,5.0
annealing,3.0,1.0,2.0,5.0,4.0
arrhythmia,3.0,1.0,2.0,4.0,5.0
audiology-std,1.0,2.0,3.0,4.0,5.0
balance-scale,3.0,5.0,4.0,1.0,2.0
balloons,3.0,2.0,1.0,5.0,4.0
bank,2.0,1.0,5.0,3.0,4.0
blood,1.0,3.0,5.0,4.0,2.0
breast-cancer,2.0,1.0,5.0,4.0,3.0
breast-cancer-wisc,1.0,3.0,4.0,2.0,5.0
breast-cancer-wisc-diag,1.0,3.0,4.0,2.0,5.0
breast-cancer-wisc-prog,2.0,1.0,3.0,5.0,4.0
breast-tissue,2.0,1.0,3.0,4.0,5.0
car,5.0,4.0,1.0,3.0,2.0
cardiotocography-3clases,3.0,2.0,1.0,5.0,4.0
cardiotocography-10clases,1.0,2.0,3.0,5.0,4.0
chess-krvkp,5.0,4.0,1.0,2.0,3.0
congressional-voting,2.0,1.0,3.0,5.0,4.0
conn-bench-sonar-mines-rocks,1.0,3.0,2.0,5.0,4.0
conn-bench-vowel-deterding,2.0,5.0,3.0,1.0,4.0
connect-4,5.0,2.0,1.0,3.0,4.0
contrac,2.0,1.0,4.0,5.0,3.0
credit-approval,1.0,4.0,2.0,3.0,5.0
cylinder-bands,3.0,1.0,2.0,4.0,5.0
dermatology,1.0,3.0,5.0,2.0,4.0
echocardiogram,1.0,2.0,3.0,4.0,5.0
ecoli,1.0,2.0,4.0,3.0,5.0
energy-y1,3.0,1.0,2.0,4.0,5.0
energy-y2,2.0,1.0,3.0,4.0,5.0
fertility,1.0,2.0,3.0,5.0,4.0
flags,3.0,1.0,2.0,5.0,4.0
glass,2.0,1.0,3.0,5.0,4.0
haberman-survival,1.0,3.0,5.0,4.0,2.0
hayes-roth,3.0,1.0,2.0,5.0,4.0
heart-cleveland,2.0,1.0,3.0,4.0,5.0
heart-hungarian,1.0,3.0,4.0,2.0,5.0
heart-switzerland,3.0,1.0,2.0,5.0,4.0
heart-va,2.0,1.0,3.0,5.0,4.0
hepatitis,3.0,2.0,1.0,5.0,4.0
hill-valley,1.0,3.0,4.0,5.0,2.0
horse-colic,3.0,1.0,2.0,4.0,5.0
ilpd-indian-liver,1.0,2.0,5.0,4.0,3.0
image-segmentation,3.0,2.0,1.0,4.0,5.0
ionosphere,3.0,1.0,2.0,4.0,5.0
iris,1.0,4.0,3.0,2.0,5.0
led-display,2.0,4.0,3.0,1.0,5.0
lenses,1.0,2.0,3.0,5.0,4.0
letter,3.0,4.0,1.0,2.0,5.0
libras,1.0,3.0,4.0,2.0,5.0
low-res-spect,1.0,2.0,3.0,5.0,4.0
lung-cancer,4.0,1.0,2.0,5.0,3.0
lymphography,2.0,1.0,3.0,4.0,5.0
mammographic,2.0,1.0,5.0,4.0,3.0
molec-biol-promoter,3.0,2.0,1.0,5.0,4.0
molec-biol-splice,3.0,2.0,1.0,4.0,5.0
monks-1,4.0,3.0,1.0,5.0,2.0
monks-2,1.0,2.0,4.0,5.0,3.0
monks-3,3.0,2.0,1.0,5.0,4.0
mushroom,4.0,3.0,2.0,1.0,5.0
musk-1,1.0,3.0,4.0,5.0,2.0
musk-2,4.0,5.0,3.0,2.0,1.0
nursery,5.0,3.0,1.0,2.0,4.0
oocytes_merluccius_nucleus_4d,1.0,3.0,5.0,2.0,4.0
oocytes_merluccius_states_2f,1.0,2.0,4.0,3.0,5.0
oocytes_trisopterus_nucleus_2f,1.0,2.0,5.0,3.0,4.0
oocytes_trisopterus_states_5b,1.0,2.0,4.0,3.0,5.0
optical,3.0,5.0,4.0,1.0,2.0
ozone,2.0,1.0,5.0,4.0,3.0
page-blocks,2.0,1.0,3.0,4.0,5.0
parkinsons,1.0,2.0,3.0,5.0,4.0
pendigits,3.0,4.0,2.0,1.0,5.0
pima,1.0,2.0,5.0,3.0,4.0
pittsburg-bridges-MATERIAL,2.0,1.0,4.0,5.0,3.0
pittsburg-bridges-REL-L,2.0,1.0,4.0,3.0,5.0
pittsburg-bridges-SPAN,1.0,2.0,4.0,5.0,3.0
pittsburg-bridges-T-OR-D,2.0,1.0,4.0,5.0,3.0
pittsburg-bridges-TYPE,2.0,1.0,5.0,4.0,3.0
planning,3.0,2.0,5.0,4.0,1.0
plant-margin,1.0,4.0,3.0,2.0,5.0
plant-shape,1.0,3.0,4.0,2.0,5.0
plant-texture,1.0,3.0,4.0,2.0,5.0
post-operative,3.0,1.0,2.0,5.0,4.0
primary-tumor,4.0,1.0,5.0,2.0,3.0
ringnorm,4.0,3.0,2.0,1.0,5.0
seeds,1.0,5.0,2.0,4.0,3.0
semeion,1.0,5.0,2.0,3.0,4.0
soybean,1.0,4.0,2.0,3.0,5.0
spambase,2.0,1.0,3.0,4.0,5.0
spect,2.0,1.0,4.0,3.0,5.0
spectf,2.0,1.0,4.0,5.0,3.0
statlog-australian-credit,2.0,3.0,4.0,5.0,1.0
statlog-german-credit,3.0,2.0,5.0,1.0,4.0
statlog-heart,1.0,2.0,3.0,4.0,5.0
statlog-image,2.0,4.0,1.0,5.0,3.0
statlog-landsat,1.0,2.0,4.0,3.0,5.0
statlog-shuttle,5.0,1.0,2.0,3.0,4.0
statlog-vehicle,1.0,2.0,4.0,5.0,3.0
steel-plates,2.0,1.0,4.0,3.0,5.0
synthetic-control,3.0,5.0,4.0,1.0,2.0
teaching,1.0,2.0,5.0,3.0,4.0
thyroid,3.0,2.0,1.0,4.0,5.0
tic-tac-toe,3.0,5.0,4.0,2.0,1.0
titanic,3.0,2.0,1.0,5.0,4.0
trains,4.0,2.0,1.0,5.0,3.0
twonorm,2.0,4.0,3.0,1.0,5.0
vertebral-column-2clases,1.0,3.0,5.0,2.0,4.0
vertebral-column-3clases,2.0,3.0,5.0,1.0,4.0
wall-following,3.0,2.0,1.0,4.0,5.0
waveform,2.0,3.0,5.0,1.0,4.0
waveform-noise,2.0,4.0,5.0,1.0,3.0
wine,1.0,4.0,2.0,3.0,5.0
wine-quality-red,2.0,1.0,5.0,4.0,3.0
wine-quality-white,2.0,1.0,4.0,5.0,3.0
yeast,1.0,2.0,5.0,3.0,4.0
zoo,2.0,3.0,4.0,1.0,5.0
