TRAINACCRANKS:,CAWPE,MLP,SVML,NN,C4.5,Logistic
abalone,3.0,1.0,5.0,4.0,6.0,2.0
acute-inflammation,2.5,2.5,2.5,5.0,6.0,2.5
acute-nephritis,2.5,2.5,5.0,2.5,6.0,2.5
adult,1.0,3.0,4.0,6.0,2.0,5.0
annealing,2.0,4.0,6.0,3.0,1.0,5.0
arrhythmia,1.0,3.0,5.0,4.0,2.0,6.0
audiology-std,1.0,2.0,3.0,6.0,4.0,5.0
balance-scale,1.0,2.0,3.0,5.0,6.0,4.0
balloons,1.0,2.0,3.0,5.0,6.0,4.0
bank,2.0,5.0,3.0,6.0,4.0,1.0
blood,1.0,2.0,6.0,5.0,4.0,3.0
breast-cancer,1.0,6.0,2.0,5.0,3.0,4.0
breast-cancer-wisc,1.0,5.0,2.0,3.0,6.0,4.0
breast-cancer-wisc-diag,2.0,4.0,1.0,3.0,6.0,5.0
breast-cancer-wisc-prog,1.0,3.0,2.0,5.0,4.0,6.0
breast-tissue,1.0,5.0,3.0,2.0,4.0,6.0
car,1.0,4.0,5.0,3.0,2.0,6.0
cardiotocography-10clases,1.0,5.0,4.0,6.0,2.0,3.0
cardiotocography-3clases,1.0,3.0,5.0,4.0,2.0,6.0
chess-krvk,1.0,4.0,5.0,3.0,2.0,6.0
chess-krvkp,2.0,3.0,5.0,6.0,1.0,4.0
congressional-voting,2.0,6.0,4.0,3.0,1.0,5.0
conn-bench-sonar-mines-rocks,1.0,3.0,4.0,2.0,5.0,6.0
conn-bench-vowel-deterding,2.0,3.0,6.0,1.0,4.0,5.0
connect-4,1.0,3.0,6.0,4.0,2.0,5.0
contrac,1.0,2.0,5.0,6.0,4.0,3.0
credit-approval,3.0,6.0,4.0,1.0,5.0,2.0
cylinder-bands,1.0,3.0,2.0,5.0,6.0,4.0
dermatology,1.0,2.0,3.0,5.0,6.0,4.0
echocardiogram,2.0,5.0,1.0,6.0,4.0,3.0
ecoli,1.0,4.0,2.0,3.0,6.0,5.0
energy-y1,2.0,3.0,5.0,6.0,1.0,4.0
energy-y2,2.0,3.0,6.0,5.0,1.0,4.0
fertility,2.0,4.0,3.0,6.0,1.0,5.0
flags,1.0,3.0,5.0,4.0,2.0,6.0
glass,1.0,4.0,6.0,3.0,2.0,5.0
haberman-survival,3.0,5.0,2.0,4.0,6.0,1.0
hayes-roth,1.0,4.0,6.0,2.0,3.0,5.0
heart-cleveland,2.0,5.0,1.0,4.0,6.0,3.0
heart-hungarian,2.0,6.0,4.0,1.0,5.0,3.0
heart-switzerland,1.0,3.0,6.0,2.0,4.5,4.5
heart-va,1.0,5.0,2.0,4.0,6.0,3.0
hepatitis,2.0,4.0,3.0,1.0,5.0,6.0
hill-valley,2.0,4.0,3.0,5.0,6.0,1.0
horse-colic,1.0,5.0,3.0,6.0,2.0,4.0
ilpd-indian-liver,1.0,3.0,4.0,6.0,5.0,2.0
image-segmentation,1.0,5.0,6.0,2.0,3.0,4.0
ionosphere,1.0,4.0,3.0,6.0,2.0,5.0
iris,1.0,2.0,5.0,3.0,6.0,4.0
led-display,2.0,5.0,3.0,1.0,6.0,4.0
lenses,1.0,4.0,2.0,5.0,6.0,3.0
letter,1.0,4.0,5.0,2.0,3.0,6.0
libras,1.0,3.0,4.0,2.0,6.0,5.0
low-res-spect,2.0,1.0,3.0,4.0,5.0,6.0
lung-cancer,1.0,3.0,5.0,6.0,4.0,2.0
lymphography,2.0,3.0,1.0,4.0,5.0,6.0
magic,1.0,2.0,6.0,4.0,3.0,5.0
mammographic,2.0,4.0,5.0,6.0,1.0,3.0
miniboone,1.0,5.0,6.0,3.0,2.0,4.0
molec-biol-promoter,1.0,4.0,5.0,3.0,6.0,2.0
molec-biol-splice,2.0,5.0,4.0,6.0,1.0,3.0
monks-1,1.0,2.0,5.0,4.0,3.0,6.0
monks-2,1.0,3.0,5.0,2.0,4.0,6.0
monks-3,2.0,3.0,5.0,4.0,1.0,6.0
mushroom,3.0,4.0,5.0,1.0,2.0,6.0
musk-1,1.0,2.0,3.0,6.0,4.0,5.0
musk-2,2.0,1.0,4.0,6.0,3.0,5.0
nursery,2.0,3.0,5.0,4.0,1.0,6.0
oocytes_merluccius_nucleus_4d,1.0,3.0,4.0,5.0,6.0,2.0
oocytes_merluccius_states_2f,1.0,4.0,2.0,5.0,6.0,3.0
oocytes_trisopterus_nucleus_2f,1.0,2.0,4.0,6.0,5.0,3.0
oocytes_trisopterus_states_5b,1.0,2.0,4.0,5.0,6.0,3.0
optical,1.0,3.0,4.0,2.0,6.0,5.0
ozone,1.0,3.0,4.0,2.0,5.0,6.0
page-blocks,1.0,4.0,6.0,5.0,2.0,3.0
parkinsons,2.0,3.0,5.0,1.0,4.0,6.0
pendigits,2.0,6.0,3.0,1.0,5.0,4.0
pima,3.0,4.0,2.0,5.0,6.0,1.0
pittsburg-bridges-MATERIAL,2.0,4.0,3.0,1.0,5.0,6.0
pittsburg-bridges-REL-L,1.0,5.0,3.5,2.0,3.5,6.0
pittsburg-bridges-SPAN,1.0,4.0,2.0,3.0,6.0,5.0
pittsburg-bridges-T-OR-D,1.0,5.0,2.0,6.0,4.0,3.0
pittsburg-bridges-TYPE,1.0,4.0,2.0,5.0,3.0,6.0
planning,2.0,6.0,3.0,5.0,1.0,4.0
plant-margin,1.0,2.0,4.0,3.0,6.0,5.0
plant-shape,1.0,3.0,4.0,2.0,6.0,5.0
plant-texture,1.0,2.0,5.0,4.0,6.0,3.0
post-operative,2.0,6.0,3.0,4.0,1.0,5.0
primary-tumor,1.0,5.0,4.0,3.0,2.0,6.0
ringnorm,1.0,2.0,5.0,6.0,3.0,4.0
seeds,1.0,2.0,4.0,5.0,6.0,3.0
semeion,1.0,3.0,2.0,4.0,6.0,5.0
soybean,1.0,2.0,3.0,5.0,6.0,4.0
spambase,1.0,5.0,4.0,6.0,3.0,2.0
spect,2.0,5.0,1.0,3.0,4.0,6.0
spectf,1.0,5.0,3.0,2.0,4.0,6.0
statlog-australian-credit,3.0,6.0,1.0,2.0,5.0,4.0
statlog-german-credit,3.0,6.0,1.0,5.0,4.0,2.0
statlog-heart,2.0,5.0,1.0,4.0,6.0,3.0
statlog-image,1.0,3.0,6.0,2.0,5.0,4.0
statlog-landsat,1.0,3.0,4.0,2.0,6.0,5.0
statlog-shuttle,3.0,4.0,6.0,2.0,1.0,5.0
statlog-vehicle,1.0,2.0,4.0,6.0,5.0,3.0
steel-plates,1.0,5.0,3.0,6.0,2.0,4.0
synthetic-control,2.0,1.0,3.0,4.0,5.0,6.0
teaching,1.0,4.0,3.0,2.0,5.0,6.0
thyroid,2.0,5.0,3.0,6.0,1.0,4.0
tic-tac-toe,2.0,5.0,3.0,1.0,6.0,4.0
titanic,2.0,4.0,6.0,1.0,3.0,5.0
trains,1.0,4.0,5.0,2.0,6.0,3.0
twonorm,3.0,5.0,1.0,4.0,6.0,2.0
vertebral-column-2clases,1.0,3.0,4.0,6.0,5.0,2.0
vertebral-column-3clases,2.0,3.0,5.0,6.0,4.0,1.0
wall-following,2.0,3.0,5.0,4.0,1.0,6.0
waveform,3.0,5.0,2.0,4.0,6.0,1.0
waveform-noise,3.0,5.0,2.0,4.0,6.0,1.0
wine,1.0,3.0,2.0,5.0,6.0,4.0
wine-quality-red,1.0,4.0,3.0,5.0,6.0,2.0
wine-quality-white,1.0,3.0,6.0,2.0,5.0,4.0
yeast,1.0,4.0,2.0,5.0,6.0,3.0
zoo,1.0,4.0,3.0,2.0,6.0,5.0
